######################
###           c c c  #
### e        c c c c #
######      ##########
###                  #
##l      t      c    #
############       ###
############    c  ###
#         ##s        #
# p       ##### c    #
###       #####   t  #
#               c ####
# s  s   e        ####
###########  s    ####
######################
