##########################
#             ############
# c c c       ############
#            r############
########  ################
########  ################
########          c      #
########tt#   e   c   e  #
################# c ######
#####           # c      #
#####           # c      #
#      ##  # i    c ######
# p    ##  ###### c #   ##
#########    e    t #r  l#
##########################
