####################################
####     i c c c r######           #
####    ###############l           #
#                    ########      #
#                                ###
#           ccc     ccc       t    #
l ps                          #    #
#####                    ###       #
#####    #####################  ####
#####                c c #####  ####
#####t   s  e  e  e c c c##r     e #
####################################
