###################################
#                                 #
#                                 #
#                                 #
#                                 #
#                                 #
#                                 #
#                                 #
#                           ###   #
#                     ###   ###   #
#               ###   ###   ###   #
#         ###   ###   ###   ###   #
# p ###   ###   ###   ###   ###   #
###################################
